Account_num,Date,Time,Deposit,Withdrawal,Total_Balance
826029746101,17/01/2022,05:26:21 PM,1000.0,0,1000.0
826029746101,17/01/2022,07:47:49 PM,100.0,0,1100.0
826029746101,17/01/2022,07:48:09 PM,200.0,0,1300.0
826029746101,17/01/2022,11:44:50 PM,500.0,0,1800.0
826029746101,18/01/2022,07:14:08 PM,0,200.0,1600.0
826029746101,18/01/2022,07:23:59 PM,0,100.0,1500.0
